"filename", "language", "Python", "XML", "comment", "blank", "total"
"d:\Course\2024\mlkit-unity-interaction\pycode\dataloader.py", "Python", 44, 0, 1, 29, 74
"d:\Course\2024\mlkit-unity-interaction\pycode\models\lstm\LSTMClassifier.py", "Python", 25, 0, 0, 14, 39
"d:\Course\2024\mlkit-unity-interaction\pycode\models\stgcn\st_gcn.py", "Python", 148, 0, 17, 38, 203
"d:\Course\2024\mlkit-unity-interaction\pycode\models\stgcn\st_gcn_twostream.py", "Python", 19, 0, 0, 7, 26
"d:\Course\2024\mlkit-unity-interaction\pycode\models\stgcn\utils\graph.py", "Python", 138, 0, 3, 18, 159
"d:\Course\2024\mlkit-unity-interaction\pycode\models\stgcn\utils\tgcn.py", "Python", 53, 0, 1, 13, 67
"d:\Course\2024\mlkit-unity-interaction\pycode\stgcn.pt", "XML", 0, 62893, 0, 257, 63150
"d:\Course\2024\mlkit-unity-interaction\pycode\test.py", "Python", 31, 0, 0, 10, 41
"d:\Course\2024\mlkit-unity-interaction\pycode\train.py", "Python", 76, 0, 12, 27, 115
"d:\Course\2024\mlkit-unity-interaction\pycode\util.py", "Python", 71, 0, 8, 32, 111
"Total", "-", 605, 62893, 42, 445, 63985